{
  "name": "Level 1.1",
  "description": "This a demonstration level.",
  "objects": "assets/objects-set-1",
  "background": "images/background-1.png",
  "map": [
    "BBBBBBBBBBBBBBBBBBBBBBBBBBBBBBBBBBBBBBBBBBBBBBBBBBBBBBBBBBBBBBBBBBBBBBBBBBBBBBBB",
    "BBBBBBBBBBBBBBBBBBBBBBBBBBBBBBBBBBBBBBBBBBBBBBBBBBBBBBBBBBBBBBBBBBBBBBBBBBBBBBBB",
    "BBBBBBBBBBBBBB                 V                                   BBBBBBBBBBBBB",
    "BBBBBBBBBBB                                                            BBBBBBBBB",
    "BBBBBBBBBBB  S                                                          BBBBBBBB",
    "BBBBBBBBBBB                                                                BBBBB",
    "BBBBBBBBBBB                                                                  BBB",
    "BBBBBBBBBBB                                                                   BB",
    "BBBBBBBBBBB        o           o                                              BB",
    "BBBBBBBBBBBBBBBBBBBBBBBBBBBBBBBBBBBBBBBBBBBBBBBBBB              o        o    BB",
    "BBBBBBBBBBBBBBBBBBBBBBBBBBBBBBBBBBBBBBBBBBBBBBBBBB     BBBBBBBBBBBBBBBBBBBBBBBBB",
    "BBB>                                                  BBBBBBBBBBBBBBBBBBBBBBBBBB",
    "BBB>  oooo         o     o                            BBBBBBBBBBBBBBBBBBBBBBBBBB",
    "BBBBBBBBBBBBBBBBBBBBBBBBBBBBBBBBBB        BhBBBBBBBBBBBBBBBBBBBBBBBBBBBBBBBBBBBB",
    "BBBBBBBBBBBBBBBBBBBBBBBBBBBBBBBBBB    BBBBBHBBBBBBBBBBBBBBBBBBBBBBBBBBBBBBBBBBBB",
    "BBBBBBBBBBBBBBBBBBBBBBBBBBBBBBBBBB    BBBBBHBBBBBBBBBBBBBBBBBBBBBBBBBBBBBBBBBBBB",
    "BBBBBBBBBBBBBBBBBBBBBBBBBBBBBBBBBB    BBBBBHBBBBBBBBBBBBBBBBBBBBBBBBBBBBBBBBBBBB",
    "BBBBBBBBBBBBBBBBBBBBBBBBBBBBBBBBBB    BBBBBHBBBBBBBBBBBBBBBBBBBBBBBBBBBBBBBBBBBB",
    "BBBBBBBBBBBBBBBBBBBBBBBBBBBBBBBBBB         H                              <BBBBB",
    "BB  O                     VVVV             H              BBhBBBBBBBBBBBBBBBBBBB",
    "BBB     BBBBBBBBBBBB                       H                H         BBBBBBBBBB",
    "BBB     BBBBBBBBBBBB                       H     o      o   H   o     BBBBBBBBBB",
    "BBB    BBBBBBBBBBBBBBBBBBBhBBBBBBB    BBBBBBBBBBBBBBBBBBBBBBBBBBBBBBBBBBBBBBBBBB",
    "BBB    VBBBBBBBBBBBBBBBBBBHBBBBBBB    BBBBBBBBBBBBBBBBBBBBBBBBBBBBBBBBBBBBBBBBBB",
    "BBB                       H   BBBB    BBBBBBBBBBBBBBBBBBBBBBBBBBBBBBBBBBBBBBBBBB",
    "BBB                       H   BBBB    BBBBBBBBBBBBBBBBBBBBBBBBBBBBBBBBBBBBBBBBBB",
    "BBBBBBBBBBB    =====k========BBBBB    BBBBBBBBBBBBBBBBBBBBBBBBBBBBBBBBBBBBBBBBBB",
    "BBBBBBBBBBB         H          BBB                                    VBBBBBBBBB",
    "BBBBBBBBBBB         H          BBB |                                   BBBBBBBBB",
    "BB            ==k==============BBBBBBBBBBBBBBBBBBBBB | BBBBBBBBBBBB    BBBBBBBBB",
    "BB              H               BBBBBBBBBBBBBBBBBBBBBBBBBBBBBBBBBBB    BBBBBBBBB",
    "BB==============k========       BBBBBBBBBBBBBBBBBBBBBBBBBBBBBBBBBBB    BBBBBBBBB",
    "BB              H              BBBBBBBBBBBBBBB   BBBBBBBBBBBBBBBBBB    BBBBBBBBB",
    "BB  oOoOoO      H              BBBBBBBBBBBBBBB    BBBBBBBBBBBBBBBBB    BBBBBBBBB",
    "BBBBBBBBBBBBBBBBBBBBBBBBBBBBBBBBBBBBBBBBBBB        BBBBBBBBBBBBBBBB    BBBBBBBBB",
    "BBBBBBBBBBBBBBBBBBBBBBBBBBBBBBBBBBBBBBBB              BBBBBBBBBBBBB    BBBBBBBBB",
    "BBBBBBBBBBB>                                                                 <BB",
    "BBBBBBBBBBB E           O                      |                     |       <BB",
    "BBBBBBBBBBBBBBBBBBBBBBBBBBBBBBBBBBBBBBBBBBBBBBBBBBBBBBBB ||| BBBBBBBBBBBBBBBBBBB",
    "BBBBBBBBBBBBBBBBBBBBBBBBBBBBBBBBBBBBBBBBBBBBBBBBBBBBBBBBBBBBBBBBBBBBBBBBBBBBBBBB"
  ]
}